NO ./textures/redbrick.xpm

S ./textures/redbrick.xpm

W  ./textures/redbrick.xpm

F 19, 52, 64

C 104, 109, 224

EA: ./textures/redbrick.xpm


111111111111111111111111111
1000000000000111100N000000011
11111111100001  10000000000001
    1111100001111000000111111
    10000000000000000001
    1111111111111111111