NO ./textures/redbrick.xpm

SO ./textures/redbrick.xpm

WE ./textures/redbrick.xpm

EA ./textures/redbrick.xpm

F 120   , 50   , 31

C 10,189,227


111111111111111
1000001111111111111111
10000010000000011000011
100000S0100010000100100111
1000000010000000000110011
1000000010000000011111011
1000001000000000000000001
10000010000010000100000001
10000010000000000000000001
1100001111111011111111111
100110000000001   
111111111111111