
    WE  ./textures/redbrick.xpm

        F  25    ,      62     ,       80

             C                                                              4,109,224













         EA  ./textures/redbrick.xpm
         NO  ./textures/redbrick.xpm
         SO  ./textures/redbrick.xpm




1111111111111111111
1000000000N00000001
1000000000000000001
1000000000000000001
1000000000000000001
1000000000000000001
1000000000000000001
1000000000000000001
1000000000000000001
1000000000000000001
1000000000000000001
1111111111111111111